00000000000000000
0WWWWWWWWWWWWWWW0
0WD-W---W----W-W0
0W----W--W-W---W0
0W--W--W----W--W0
0W----W---W----W0
0WW-W---W---WW-W0
0W---W----W----W0
0W-W-W-WW-W-W--W0
0W-W---W-----W-W0
0W--W----W-W---W0
0WW-W-W--W-W-W-W0
0W---W----W---WW0
0W-W---W---W---W0
0W-W-W----W--W-W0
0WWWWWWWWWWWWWGW0
00000001230000000