WWWWWWWWWWWWWWW
W--W---W----W-W
W----W--W-W---W
W--W--W----W--W
W--------W----W
WWWW---W---WW-W
W---W----W----W
W-W-W-WW-W-W--W
W-W---W-----W-W
W--W----W-W---W
WW-W-W--W-W-W-W
W---W----W---WW
W-W-----W-W---W
W-W-W----W--W-W
WWWWWWWWWWWWWGW